..........#.................
...S......#.................
..........#.....#####.......
..........#.................
..........#.................
..........#.................
..........#......#..........
..........#......#..........
.................#..........
.................#..........
.................#.....X....
.................#..........
.................#..........